MMMMMMMMMMMMMMMMMMMMMMMMMMMMMMMMMMMMMMMMMMMMMMMMMMMMMMMMMMMMMMMMMMMMMMMMMMMMMMMM
MMM        1    F         2    C                                          MMMMMM
MMM  MMMMMMMM   MMM   MMMMMMMMMM  MMMMMMMMM  MMMMMMMMMMMMM     MMMMMMMMM  MMMMMM
MMM  MMMMMMMM   MMM   MMMMMMMMMM  MMMMMMMMM  MMMMMMMMMMMMM     MMMMMMMMM  MMMMMM
MMM  MMMMMMMM   MMM   MMMMMMMMMM             MMMMMMMMMMMMM     MMMMMMMMM  MMMMMM
MMM                        P                                              MMMMMM
MMM  MMMMMMMM   MMMMMMMMMMMMMMMM                   MMMMMMM     MMMMMMMMMMMMMMMMM
MMM  MMMMMMMM   MMMMMMMMMMMMMMMM                   MMMMMMM     MMMMMMMMMMMMMMMMM
MMM  MMMMMMMM   MMMMMMMMMMMMMMMM                   MMMMMMM     MMMMMMMMMMMMMMMMM
MMM  MMMMMMMM          MMMMMMMMM                   MMMMMMM     MMMMMMMMMMMMMMMMM
MMM  MMMMMMMM          MMMMMMMMM                   MMMMMMM                 MMMMM
MMM  MMMMMMMM          MMMMMMMMM                   MMMMMMM                 MMMMM
MMM                    MMMMMMMMM                   MMMMMMMMMMMMMMMMMMMMMMMMMMMMM
MMMMMMMMMMMMMMMMMMMMMMMMMMMMMMMM                   MMMMMMMMMMMMMMMMMMMMMMMMMMMMM
MMMMMMMMMMMMMMMMMMMMMMMMMMMMMMMMMMMMMMMMMMMMMMMMMMMMMMMMMMMMMMMMMMMMMMMMMMMMMMMM
MMMMMMMMMMMMMMMMMMMMMMMMMMMMMMMMMMMMMMMMMMMMMMMMMMMMMMMMMMMMMMMMMMMMMMMMMMMMMMMM
